 5 16
|--------------|
|.F.|..-....|..|
|..-|.@B.......|
|.F....-.......|
|--------------|
